[
    {
        "name": "test",
        "menus":[],
        "tiles":[
            ["w","s","w"," ","w"," "," "," "," "," ","w"," "],
            [" "," ","w"," "," "," "," "," "," "," ","w"," "],
            [" "," ","w"," "," "," "," "," "," "," ","w","w"],
            [" ","w","w","w"," "," "," "," "," "," "," "," "],
            [" "," ","w"," "," "," "," "," "," "," "," ","w"],
            ["w","w"," "," "," "," "," "," "," ","w"," "," "],
            [" "," ","w"," ","w"," "," "," ","w","w","w","w"],
            ["w","w","w","w","w","w"," "," ","w"," ","w"," "],
            [" ","w"," ","w"," "," "," "," "," "," "," ","g"]
           
        ],
        "wall_tileset": "wall_normal",
        "enemy_tileset": "enemy_normal"
    }
]