[
    {
        "name": "test",
        "menus":[],
        "tiles":[
            ["w"," ","w"," ","w"," "," "," "," "," ","w"," "],
            [" "," ","w"," "," "," "," "," "," "," ","w"," "],
            [" "," ","w"," "," "," "," "," "," "," ","w","w"],
            [" ","w","w","w"," "," "," "," "," "," "," "," "],
            [" "," ","w"," "," "," "," "," "," "," "," ","w"],
            ["w","w"," "," "," "," "," "," "," ","w"," "," "],
            [" "," ","w"," ","w"," "," "," ","w","w","w","w"],
            ["w","w","w","w","w","w"," "," ","w"," ","w"," "],
            [" ","w"," ","w"," "," "," "," "," "," "," "," "]
           
        ],
        "tileset": "normal",
        "spawners":[]
    }
]